1 13 15
###############
#p    *fs** 1 #
#####s##### ###
#**     1**  *#
######### #####
# ** f* 1  f  #
# ###########f#
# 1	*  ***    #
#########**####
#   fs***     #
##### #########
#*     2    *x#
###############