3 13 31
###############################
#p     ** *    * 2 *  * * *   #
#*#*#*#*# # #*#*# # # #*#*#*# #
#f*s  1   ***  *  1   *   * * #
#*# # # # #*# # #*#*# # # # #*#
#*  * *    x **2 *  *   1     #
# # # # # # # # # #*# #*# # # #
#*  *  *   *  *  *   *   *    #
# # # # #*# # # #*#*# # # # # #
#*  * **  *       *        1  #
# #*# # # # # # #*# # # # # # #
#    2      *   *  *          #
###############################