3 23 15
###############
#p     **s*   #
#*#*#*#*# # # #
#f*s  1   **  #
#*# # # # #*# #
#*  *b*   s   #
# # # # # # # #
#*  * b*   *  #
# # #f# #*# # #
#* 1* **  *   #
# #*# # # # # #
#    2        #
#***#** ****#f#
#    ****     #
# # # # # # # #
#             #
# # # # # # # #
#  #    #     #
#  #   #  # # #
#   2         #
# 2  2  2     #
#     2    x  #
###############
