1 13 15
###############
#p    xfs**   #
#####s##### ###
#**      **  *#
######### #####
# ** f*    f  #
# ###########f#
#   *  ***    #
#########**####
#   fs***     #
##### #########
#*          *x#
###############