1 13 15
###############
#p s  ****b  e#
# #*#*#*#f#*# #
#b ** *s  ****#
# #** # #b#*  #
#f  s#f *f  b #
# # * * # #s *#
#*b#** b * *  #
#f# **# **# f #
#*  b **  * s #
#b#*#** #f# **#
# *f*s f  b **#
###############