1 19 11
###########
#p       *#
#*      1 #
#* *   # ##
# 1* *# 1i#
#   *   #*#
# #* i #  #
#  1   ## #
###       #
#*   *   *#
##  1    *#
##i*      #
#*1#  #   #
#     ##  #
#     ii**#
#   #i1   #
##**  *#1*#
#*##    * #
###########
